PRRRPRRRPRRRRRRRRRRRRRRSSSSSSSSS
PRPPPPPPPPPPPPSSSSSSSSSSSSSSSSSS
PRRRPRRRPRRRPRRRPRRRRRRRRRRRRRSS
PRPRPRPSSSSSSSSSSSSSSSSSSSSSSSSS
PRRRPRRRPRRRPRRRPRRRRRRRRRRRRSSS
PRPRPRPRPRPRPSSSSSSSSSSSSSSSSSSS
PRRRPRRRPRRRPRRRRRRRRRRRRRRRRSSS
PRRRPRRRPRRRPRPRPRPRPRPRPRSSSSSS
PRRRPRRRPRRRPRRRPRPRPRPRSSSSSSSS
PRRRPRRRPRRRPRRRPRRRPRRRPRRRPSSS
PRPPPPPPPPPPPPPPPPSSSSSSSSSSSSSS
PRPRPRPPSSSSSSSSSSSSSSSSSSSSSSSS
PRRRRRRRRSSSSSSSSSSSSSSSSSSSSSSS
PRRRPRRRPRRRPRRRPRRRPRPRPRPRPSSS
PRRRPRRRPRRRPRRRRRRRRRRRRRRRRRSS
PRPRPRPRPRPRPRPRPRPPPPSSSSSSSSSS
PRRRRRRRRRRRSSSSSSSSSSSSSSSSSSSS
PRPRPRPRPRPRPRPRPRPRPRPPPPPPPPSS
PRPRPRPPPPPPPPPSSSSSSSSSSSSSSSSS
PRRRPRRRPRRRPRRRRRRRRRRRRRRRSSSS
PRPRPRPRPRPRPRPRPRPRPPPPPPPPSSSS
PRRRPRRRPRRRPRRRPRRRRRSSSSSSSSSS
PRRRPRRRPRRRRRRRRRRRRRSSSSSSSSSS
PRPRPRPRPRPRPRPRPRPRPRPRPPPPPPPS
PRRRPRRRPRPRPRPRPRPRPRPRPRPRPRSS
PRRRPRRRPRRRRRRRRRRRRRRRRRSSSSSS
PRPRPRPRPRPRPRPRPRPRPRPRPRPRSSSS
PRRRPRRRPRRRPRRRPRRRPRRRPRPRPRPS
PRPRPRPRPRPRPRPRPRPRPRPPPPSSSSSS
PRRRPRRRPRRRPRRRPRPRPSSSSSSSSSSS
PRRRPRRRPRRRPRRRPRRRRSSSSSSSSSSS
PRRRPRRRPRRRPRRRPRRRRRRRRSSSSSSS
PRRRPRPRPRPRPRPRSSSSSSSSSSSSSSSS
PRRRPRRRPRRRRRRRRRRRRRSSSSSSSSSS
PRRRPRPRPRPRPRPRPRPRPRPRPRPRPSSS
PRPRPRPRPRPPPPPPPPPPPPPPPPPSSSSS
PRPRPRPRPRPPPPPPPPPPPPSSSSSSSSSS
PRPRPRPRPRPRPRPRPRPRPPPPPPPPPPPS
PRRRPRRRPRPRPRPRPRPRPRPRPRPRPSSS
PRRRPRRRPRRRRRRRRRRRRRSSSSSSSSSS
PRRRRRRRRRRRRRRRSSSSSSSSSSSSSSSS
PRPRPRPRPRPRPRPRPRPRPRPPPPPPPPPS
PRRRPRRRPRRRPRRRPRRRRRRRSSSSSSSS
PRRRPRRRPRRRPRRRRRRRSSSSSSSSSSSS
PRRRPRRRPRRRPRRRPRRRPRRRRRRSSSSS
PRRRPRRRRRRRRRRRRRRRRRSSSSSSSSSS
PRRRPRRRPRRRPRRRPRRRSSSSSSSSSSSS
PRPRPPPPPPPPPPPPPPPPPPSSSSSSSSSS
PRRRPRRRPRRRRRRRSSSSSSSSSSSSSSSS
PRRRPRRRPRRRPRRRPRRRPRRRPRPRPSSS
