PRRRPRRRPRPRPSSSSSSSSSSSSSSSSSSS
PRRRPRRRPRRRPRRRPRRRPRRRPRRRPSSS
PRPRPRPRPRPRPRPRPRPRPRPRPRPRPRPS
PRRRPRRRPRRRPRPRPRPRPSSSSSSSSSSS
PRPRPRPRPRPRPRPRPPPPPPPPPPPPPSSS
PRPRPPPPPPPSSSSSSSSSSSSSSSSSSSSS
PRRRPRRRPRRRPRRRPRRRPRRRPRRRPSSS
PRRRPRRRPRRRPRRRPRRRPRRRPSSSSSSS
PRPRPRPRPRPRPPPPPPSSSSSSSSSSSSSS
PRRRPRRRPRRRPRRRPRPRPRPSSSSSSSSS
PRPRPRPPPPPPPPPPPPPPPPPPPPPPPPSS
PRRRPRRRPRRRPRRRPRRRPRRRPRRRPSSS
PRRRPRRRPRPRSSSSSSSSSSSSSSSSSSSS
PRRRPRRRPRRRPRRRPRPSSSSSSSSSSSSS
PRRRPRRRPRRRPRRRPRRRPRRRPRPRPSSS
PRPRPRPRPRPRPRPRPRPRPRPRPRPRPRSS
PRRRPRRRPRRRPRRRSSSSSSSSSSSSSSSS
PRPRPRPPPPPPPPPPPPPPPPPPPPSSSSSS
PRPRPRPRPRPRPRPRPRPRPRPRPRPRPRPS
PRRRPRRRPRRRPRRRPRRRPRRRPRRRPRPS
PRPRPRPRPRPRPSSSSSSSSSSSSSSSSSSS
PRPRPRPRPRPPPPPPPPPPPPPPSSSSSSSS
PRPPPPPPPPSSSSSSSSSSSSSSSSSSSSSS
PRRRPRRRPRRRPRRRPRPRPRPRPRPRSSSS
PRRRPRRRPRRRPRRRPRPRPRSSSSSSSSSS
PRPRPRPRPRPSSSSSSSSSSSSSSSSSSSSS
PRRRPRRRPRRRPRPRPRPRPRSSSSSSSSSS
PRPRPRPRPRPPPPPPPSSSSSSSSSSSSSSS
PRRRPRRRPRPRPRPRPRPRPRSSSSSSSSSS
PRRRPRRRPRRRPRRRPRRRPRPRPRPRPRSS
PRPRPRPRPRPRPPPSSSSSSSSSSSSSSSSS
PRPRPRPRPPPPPPPPPPPPPPPSSSSSSSSS
PRPRPRPPPPSSSSSSSSSSSSSSSSSSSSSS
PRRRPRRRPRRRPRPRPRPRPRPRPRPRPSSS
PRPRPRPRPRPRPRPSSSSSSSSSSSSSSSSS
PRPRPRPPPPPPPPPPPPPPPPPPPPPPPSSS
PRPRPRPRPRPPPPPPPPPPPPPPSSSSSSSS
PRPRPRPRPRPRPRPRPPPPPPPPPPPPPPPS
PRRRPRRRPRRRPRRRPRPRPRPRPSSSSSSS
PRPRPRPPPPPPPPPPPPPPPPPPPPPPSSSS
PRRRPRRRPRPRPRPRPRPRPRSSSSSSSSSS
PRRRPRRRPRRRPRRRPRRRPRPRPRPRPSSS
PRPRPRPRPRPRPRPRPRPRPRPPPSSSSSSS
PRPRPPPPPPPPPPPPPPPPSSSSSSSSSSSS
PRPPPPPPPSSSSSSSSSSSSSSSSSSSSSSS
PRRRPRPRPRPRPRPRPRPRPRPSSSSSSSSS
PRPPPPPPPPPPPPPPPPPPPPPPPSSSSSSS
PRPRPRPRPRPRPPPPPPPPPPPPPPPPSSSS
PRRRPRRRPRRRPRRRPRRRPRPRPRPRSSSS
PRPRPPPPPPPPPPPPPPPPPPPPPPSSSSSS
