PRPRPRPRPRRRRSSSSSSSSSSSSSSSSSSS  PPPPPRRSSSSSSSSS  PPPRSSSS
PRPRPRPRPRPRPRPRRRRRRRRRRRRRRSSS  PPPPPPPPRRRRRRRS  PPPPRRRR
PRPRPRPRPRPRPRPRPRPRPRPRPRPRPRPS  PPPPPPPPPPPPPPPS  PPPPPPPS
PRPRPRPRPRPRPRPRRRRRRSSSSSSSSSSS  PPPPPPPPRRRSSSSS  PPPPRRSS
PRPRPRPRPRPRPRPRPPPPPPPPPPPPPSSS  PPPPPPPPPPPPPPSS  PPPPPPPS
PRPRPPPPPPPSSSSSSSSSSSSSSSSSSSSS  PPPPPSSSSSSSSSSS  PPSSSSSS
PRPRPRPRPRPRPRPRRRRRRRRRRRRRRSSS  PPPPPPPPRRRRRRRS  PPPPRRRR
PRPRPRPRPRPRPRRRRRRRRRRRRSSSSSSS  PPPPPPPRRRRRRSSS  PPPPRRRS
PRPRPRPRPRPRPPPPPPSSSSSSSSSSSSSS  PPPPPPPPPSSSSSSS  PPPPSSSS
PRPRPRPRPRPRPRPRRRRRRRRSSSSSSSSS  PPPPPPPPRRRRSSSS  PPPPRRSS
PRPRPRPPPPPPPPPPPPPPPPPPPPPPPPSS  PPPPPPPPPPPPPPPS  PPPPPPPS
PRPRPRPRPRPRPRPRRRRRRRRRRRRRRSSS  PPPPPPPPRRRRRRRS  PPPPRRRR
PRPRPRPRRRRRSSSSSSSSSSSSSSSSSSSS  PPPPRRSSSSSSSSSS  PPRSSSSS
PRPRPRPRPRPRRRRRRRRSSSSSSSSSSSSS  PPPPPPRRRRSSSSSS  PPPRRSSS
PRPRPRPRPRPRPRPRPRRRRRRRRRRRRSSS  PPPPPPPPPRRRRRRS  PPPPPRRR
PRPRPRPRPRPRPRPRPRPRPRPRPRPRPRSS  PPPPPPPPPPPPPPPS  PPPPPPPS
PRPRPRPRRRRRRRRSSSSSSSSSSSSSSSSS  PPPPRRRRSSSSSSSS  PPRRSSSS
PRPRPRPPPPPPPPPPPPPPPPPPPPSSSSSS  PPPPPPPPPPPPPSSS  PPPPPPSS
PRPRPRPRPRPRPRPRPRPRPRPRPRPRPRPS  PPPPPPPPPPPPPPPS  PPPPPPPS
PRPRPRPRPRPRPRPRPRRRRRRRRRRRRRRS  PPPPPPPPPRRRRRRR  PPPPPRRR
PRPRPRPRPRPRPSSSSSSSSSSSSSSSSSSS  PPPPPPSSSSSSSSSS  PPPSSSSS
PRPRPRPRPRPPPPPPPPPPPPPPSSSSSSSS  PPPPPPPPPPPPSSSS  PPPPPPSS
PRPPPPPPPPSSSSSSSSSSSSSSSSSSSSSS  PPPPPSSSSSSSSSSS  PPSSSSSS
PRPRPRPRPRPRPRPRPRPRRRRRRRRRSSSS  PPPPPPPPPPRRRRSS  PPPPPRRS
PRPRPRPRPRPRPRRRRRRRRRSSSSSSSSSS  PPPPPPPRRRRSSSSS  PPPPRRSS
PRPRPRPRPRPSSSSSSSSSSSSSSSSSSSSS  PPPPPSSSSSSSSSSS  PPSSSSSS
PRPRPRPRPRPRPRPRRRRRRRSSSSSSSSSS  PPPPPPPPRRRSSSSS  PPPPRRSS
PRPRPRPRPRPPPPPPPSSSSSSSSSSSSSSS  PPPPPPPPSSSSSSSS  PPPPSSSS
PRPRPRPRPRPRPRPRPRRRRRSSSSSSSSSS  PPPPPPPPPRRSSSSS  PPPPPRSS
PRPRPRPRPRPRPRPRPRPRRRRRRRRRRRSS  PPPPPPPPPPRRRRRS  PPPPPRRR
PRPRPRPRPRPRPPPSSSSSSSSSSSSSSSSS  PPPPPPPSSSSSSSSS  PPPSSSSS
PRPRPRPRPPPPPPPPPPPPPPPSSSSSSSSS  PPPPPPPPPPPSSSSS  PPPPPSSS
PRPRPRPPPPSSSSSSSSSSSSSSSSSSSSSS  PPPPPSSSSSSSSSSS  PPSSSSSS
PRPRPRPRPRPRPRPRPRPRPRPRRRRRRSSS  PPPPPPPPPPPPRRRS  PPPPPPRR
PRPRPRPRPRPRPRPSSSSSSSSSSSSSSSSS  PPPPPPPSSSSSSSSS  PPPSSSSS
PRPRPRPPPPPPPPPPPPPPPPPPPPPPPSSS  PPPPPPPPPPPPPPSS  PPPPPPPS
PRPRPRPRPRPPPPPPPPPPPPPPSSSSSSSS  PPPPPPPPPPPPSSSS  PPPPPPSS
PRPRPRPRPRPRPRPRPPPPPPPPPPPPPPPS  PPPPPPPPPPPPPPPS  PPPPPPPS
PRPRPRPRPRPRPRPRPRRRRRRRRSSSSSSS  PPPPPPPPPRRRRSSS  PPPPPRRS
PRPRPRPPPPPPPPPPPPPPPPPPPPPPSSSS  PPPPPPPPPPPPPPSS  PPPPPPPS
PRPRPRPRPRPRPRPRPRRRRRSSSSSSSSSS  PPPPPPPPPRRSSSSS  PPPPPRSS
PRPRPRPRPRPRPRPRPRPRRRRRRRRRRSSS  PPPPPPPPPPRRRRRS  PPPPPRRR
PRPRPRPRPRPRPRPRPRPRPRPPPSSSSSSS  PPPPPPPPPPPPSSSS  PPPPPPSS
PRPRPPPPPPPPPPPPPPPPSSSSSSSSSSSS  PPPPPPPPPPSSSSSS  PPPPPSSS
PRPPPPPPPSSSSSSSSSSSSSSSSSSSSSSS  PPPPSSSSSSSSSSSS  PPSSSSSS
PRPRPRPRPRPRPRPRPRPRPRRSSSSSSSSS  PPPPPPPPPPPRSSSS  PPPPPPSS
PRPPPPPPPPPPPPPPPPPPPPPPPSSSSSSS  PPPPPPPPPPPPSSSS  PPPPPPSS
PRPRPRPRPRPRPPPPPPPPPPPPPPPPSSSS  PPPPPPPPPPPPPPSS  PPPPPPPS
PRPRPRPRPRPRPRPRPRRRRRRRRRRRSSSS  PPPPPPPPPRRRRRSS  PPPPPRRS
PRPRPPPPPPPPPPPPPPPPPPPPPPSSSSSS  PPPPPPPPPPPPPSSS  PPPPPPSS
