PRRRPRRRPRRRRRRRRRRRRRRSSSSSSSSS PRPRPRRRRRRRSSSS  PPPRRRSS
PRPPPPPPPPPPPPSSSSSSSSSSSSSSSSSS PPPPPPPSSSSSSSSS  PPPSSSSS
PRRRPRRRPRRRPRRRPRRRRRRRRRRRRRSS PRPRPRPRPRRRRRRS  PPPPPRRR
PRPRPRPSSSSSSSSSSSSSSSSSSSSSSSSS PPPSSSSSSSSSSSSS  PSSSSSSS
PRRRPRRRPRRRPRRRPRRRRRRRRRRRRSSS PRPRPRPRPRRRRRRS  PPPPPRRR
PRPRPRPRPRPRPSSSSSSSSSSSSSSSSSSS PPPPPPSSSSSSSSSS  PPPSSSSS
PRRRPRRRPRRRPRRRRRRRRRRRRRRRRSSS PRPRPRPRRRRRRRRS  PPPPRRRR
PRRRPRRRPRRRPRPRPRPRPRPRPRSSSSSS PRPRPRPPPPPPPSSS  PPPPPPSS
PRRRPRRRPRRRPRRRPRPRPRPRSSSSSSSS PRPRPRPRPPPPSSSS  PPPPPPSS
PRRRPRRRPRRRPRRRPRRRPRRRPRRRPSSS PRPRPRPRPRPRPRSS  PPPPPPPS
PRPPPPPPPPPPPPPPPPSSSSSSSSSSSSSS PPPPPPPPPSSSSSSS  PPPPSSSS
PRPRPRPPSSSSSSSSSSSSSSSSSSSSSSSS PPPPSSSSSSSSSSSS  PPSSSSSS
PRRRRRRRRSSSSSSSSSSSSSSSSSSSSSSS PRRRRSSSSSSSSSSS  PRRSSSSS
PRRRPRRRPRRRPRRRPRRRPRPRPRPRPSSS PRPRPRPRPRPPPPSS  PPPPPPPS
PRRRPRRRPRRRPRRRRRRRRRRRRRRRRRSS PRPRPRPRRRRRRRRS  PPPPRRRR
PRPRPRPRPRPRPRPRPRPPPPSSSSSSSSSS PPPPPPPPPPPSSSSS  PPPPPSSS
PRRRRRRRRRRRSSSSSSSSSSSSSSSSSSSS PRRRRRSSSSSSSSSS  PRRSSSSS
PRPRPRPRPRPRPRPRPRPRPRPPPPPPPPSS PPPPPPPPPPPPPPPS  PPPPPPPS
PRPRPRPPPPPPPPPSSSSSSSSSSSSSSSSS PPPPPPPSSSSSSSSS  PPPSSSSS
PRRRPRRRPRRRPRRRRRRRRRRRRRRRSSSS PRPRPRPRRRRRRRSS  PPPPRRRS
PRPRPRPRPRPRPRPRPRPRPPPPPPPPSSSS PPPPPPPPPPPPPPSS  PPPPPPPS
PRRRPRRRPRRRPRRRPRRRRRSSSSSSSSSS PRPRPRPRPRRSSSSS  PPPPPRSS
PRRRPRRRPRRRRRRRRRRRRRSSSSSSSSSS PRPRPRRRRRRSSSSS  PPPRRRSS
PRPRPRPRPRPRPRPRPRPRPRPRPPPPPPPS PPPPPPPPPPPPPPPS  PPPPPPPS
PRRRPRRRPRPRPRPRPRPRPRPRPRPRPRSS PRPRPPPPPPPPPPPS  PPPPPPPS
PRRRPRRRPRRRRRRRRRRRRRRRRRSSSSSS PRPRPRRRRRRRRSSS  PPPRRRRS
PRPRPRPRPRPRPRPRPRPRPRPRPRPRSSSS PPPPPPPPPPPPPPSS  PPPPPPPS
PRRRPRRRPRRRPRRRPRRRPRRRPRPRPRPS PRPRPRPRPRPRPPPS  PPPPPPPS
PRPRPRPRPRPRPRPRPRPRPRPPPPSSSSSS PPPPPPPPPPPPPSSS  PPPPPPSS
PRRRPRRRPRRRPRRRPRPRPSSSSSSSSSSS PRPRPRPRPPSSSSSS  PPPPPSSS
PRRRPRRRPRRRPRRRPRRRRSSSSSSSSSSS PRPRPRPRPRRSSSSS  PPPPPRSS
PRRRPRRRPRRRPRRRPRRRRRRRRSSSSSSS PRPRPRPRPRRRRSSS  PPPPPRRS
PRRRPRPRPRPRPRPRSSSSSSSSSSSSSSSS PRPPPPPPSSSSSSSS  PPPPSSSS
PRRRPRRRPRRRRRRRRRRRRRSSSSSSSSSS PRPRPRRRRRRSSSSS  PPPRRRSS
PRRRPRPRPRPRPRPRPRPRPRPRPRPRPSSS PRPPPPPPPPPPPPSS  PPPPPPPS
PRPRPRPRPRPPPPPPPPPPPPPPPPPSSSSS PPPPPPPPPPPPPSSS  PPPPPPSS
PRPRPRPRPRPPPPPPPPPPPPSSSSSSSSSS PPPPPPPPPPPSSSSS  PPPPPSSS
PRPRPRPRPRPRPRPRPRPRPPPPPPPPPPPS PPPPPPPPPPPPPPPS  PPPPPPPS
PRRRPRRRPRPRPRPRPRPRPRPRPRPRPSSS PRPRPPPPPPPPPPSS  PPPPPPPS
PRRRPRRRPRRRRRRRRRRRRRSSSSSSSSSS PRPRPRRRRRRSSSSS  PPPRRRSS
PRRRRRRRRRRRRRRRSSSSSSSSSSSSSSSS PRRRRRRRSSSSSSSS  PRRRSSSS
PRPRPRPRPRPRPRPRPRPRPRPPPPPPPPPS PPPPPPPPPPPPPPPS  PPPPPPPS
PRRRPRRRPRRRPRRRPRRRRRRRSSSSSSSS PRPRPRPRPRRRSSSS  PPPPPRSS
PRRRPRRRPRRRPRRRRRRRSSSSSSSSSSSS PRPRPRPRRRSSSSSS  PPPPRSSS
PRRRPRRRPRRRPRRRPRRRPRRRRRRSSSSS PRPRPRPRPRPRRRSS  PPPPPPRS
PRRRPRRRRRRRRRRRRRRRRRSSSSSSSSSS PRPRRRRRRRRSSSSS  PPRRRRSS
PRRRPRRRPRRRPRRRPRRRSSSSSSSSSSSS PRPRPRPRPRSSSSSS  PPPPPSSS
PRPRPPPPPPPPPPPPPPPPPPSSSSSSSSSS PPPPPPPPPPPSSSSS  PPPPPSSS
PRRRPRRRPRRRRRRRSSSSSSSSSSSSSSSS PRPRPRRRSSSSSSSS  PPPRSSSS
PRRRPRRRPRRRPRRRPRRRPRRRPRPRPSSS PRPRPRPRPRPRPPSS  PPPPPPPS
